タイトル	担当GM	体験済
グロリアメモリーズ	きゅう、れみあ	きゅう、えなみ、れみあ、れいにー、 、ぽん、ソウタン、しらやま、りんな、つばめ、えりん、らぼ、じの、さき、ぽったー、ソルト
マーダー・オブ・パイレーツ	えなみ	ほがらか、みずき、えりん、れいにー
BrightChoice	えなみ、きゅう、れみあ	ぽん、きゅう、ほがらか、りえぞー、 、えなみ、みずき、れみあ、まつい、れいにー、labo、じの、つばめ、ぽったー、ソルト、モリシ、えりん
裁くもの、裁かれるもの	れいにー、きゅう、えなみ	ぽん、えりん、れいにー、れみあ、きゅう、まつい、みずき、ほがらか、えなみ、  、ぴよな、labo、あんころ、じの、しらやま、だいこん、ぽったー、崎、モリシ、つばめ、そら
星	りえぞー（予定）準備中	ぽん、きゅう、えなみ、つばめ、あんころ
清流館の秘宝	まつい	れいにー、まつい、れみあ、えりん、ほがらか、えなみ、きゅう、つばめ
奪うもの、奪われるもの	れいにー、きゅう	れいにー、きゅう、まつい、みずき、れみあ、ほがらか、えなみ、崎、えりん
超特急の呪いの館で撮れ高足りてますか？	キュウ、そら、ぴよな、あんころ(11/7テスト)	ソラ、ぴよな、まつい、りんな、あんころ、じの、つばめ、ぽったー、kanade
BBA	みずき、つばめ、りえぞー	みずき、れいにー、きゅう、れみあ、りえぞー、 、まつい、えりん、えなみ、つばめ、ぴよな(予定1/20)、しらやま、あんころ、labo、ソラ、じの、ぽったー、モリシ
曙光のエテルナ	えりん（11月上旬テスト）、じの、つばめ、しらやま(10月テスト)	りんな、しらやま、えりん、じの、つばめ、あんころ、温風リン
DearmyD	れみあ、えなみ、れいにー、つばめ、崎（覚えたい）	 みくみん、みずき、ぽん、れみあ、きゅう、えなみ、れいにー、えりん、崎、つばめ、labo、しらやま(予定)、ソラ、渚咲
Iwillex-	ぽん、れみあ、えなみ、れいにー、崎（覚えたい）	みずき、ぽん、れいにー、れみあ、きゅう、まつい、えなみ、えりん、崎、labo、じの、ぽったー、渚咲
Recollection	みずき、しらやま、そら	みずき、ぽん、えりん、れいにー、れみあ、きゅう、まつい、みくみん、りえぞー、ほがらか、えなみ、しらやま、あんころ、ミカノハ、だいこん、ソラ、りんな、ソウタン、じの
WANTEDz	まつい、えなみ	みずき、ぽん、れいにー、きゅう、まつい、ほがらか、えなみ
アンフィスバエナと聖女の祈り	 、ぽん、りえぞー、まつい	えりん、みずき、ぽん、えなみ、れいにー、まつい、きゅう、れみあ、ほがらか、ソウタン、ぴよな、つばめ、じの、崎、だいこん、ソラ、labo、モリシ、ソルト
ウロボロスの眠り	えなみ、まつい、きゅう	 、ぽん、きゅう、まつい、りえぞー、ほがらか、えなみ、れみあ、れいにー、ぴよな(予定1/20)
クリエイターズハイ	えなみ、きゅう、りえぞー	ぽん、きゅう、まつい、ほがらか、えなみ、えりん、れいにー、labo、ぽったー、じの
つわものどもが夢のあと	みずき、きゅう、れいにー	 みずき、えりん、れいにー、れみあ、きゅう、りえぞー、えなみ、ぽん、ソラ
ドクター・テラスの秘密の実験	えなみ、きゅう	みくみん、ぽん、れみあ、れいにー、まつい、ほがらか、えなみ、えりん、きゅう、古賀、ぽったー
バベルの末裔	えなみ、りえぞー	きゅう、りえぞー、えなみ、ぽったー
ヒーロースクランブル	えなみ	ぽん、えなみ、みずき、れいにー、きゅう
ひぐらしのなく頃に　恨返し編	りえぞー	ぽん、古賀、りえぞー、ほがらか、えなみ
フェイクドナー	えりん、みずき、れいにー、しらやま	 、みくみん、えりん、れいにー、きゅう、みずき、まつい、ぽん、えなみ、ほがらか、れみあ、崎、しらやま、labo、ソラ、あんころ、りんな、ぽったー、だいこん
リアルマダミス-MurderWonderLand	みずき、えりん、れいにー、つばめ	みずき、えりん、ぽん、れいにー、古賀、えなみ、りえぞー、まつい、れみあ、つばめ、ぽったー、崎、渚咲
リアルマダミス-盤上の教皇	みずき、れいにー	きゅう、えりん、みずき、まつい、れみあ、ぽん、れいにー、えなみ、りんな、ぽったー
リトルワンダー	みずき、つばめ	れいにー、みずき、えなみ、きゅう、ほがらか、りんな、じの、あんころ、つばめ、labo、ぴよな、しらやま、ミカノハ、だいこん、ぽったー、ソラ、モリシ、温風リン
悪意の岐路に立つ	まつい、えなみ	ぽん、れみあ、きゅう、まつい、えりん、れいにー、みずき、ほがらか、えなみ、labo、ぽったー
或ル胡蝶ノ夢	りえぞー、  、ぽん、まつい、えりん、みずき、あんころ、キュウ、りんな、しらやま（オンオフどちらも可）、崎（オンのみ）	えりん、みずき、ぽん、れいにー、古賀、ほがらか、まつい、えなみ、きゅう、しらやま、labo、りんな、あんころ、つばめ、崎、ミカノハ、ぽったー、じの、ぴよな、だいこん
花街リグレット	きゅう、りえぞー、えりん、みずき、しらやま、じの	きゅう、えなみ、りえぞー、えりん、 、しらやま、ソウタン、りんな、ぽん、つばめ、れいにー、ソラ、じの、ぽったー、ソルト
銀世界のアシアト(５月まで）	えなみ、きゅう、まつい、りんな、しらやま、ぴよな、ソルト、りえぞー、崎、ソラ	えなみ、 、ほがらか、ソウタン、しらやま、labo、まつい、れみあ、ぴよな、りんな、あんころ、じの、つばめ、えりん(12/28予定)、れいにー、ソラ、崎、ミカノハ、だいこん、ぽったー、モリシ、みずき
黒と白の狭間に	えなみ、えりん、れみあ、しらやま、つばめ	みくみん、ぽん、えりん、きゅう、ほがらか、えなみ、れみあ、れいにー、えなみ、古賀、りえぞー、みずき、ソウタン、まつい、つばめ、しらやま、じの
裁判員の仮面	えなみ、まつい	 ぽん、きゅう、まつい、れみあ、ほがらか、えなみ、じの、れいにー(3/26)、ぽったー
歯に噛むあなたに	きゅう	みずき、えりん、 、labo、れいにー、崎、ぽったー
鹿神館の罪人	まつい、えなみ	 、ぽん、れみあ、きゅう、まつい、ほがらか、えなみ、れいにー
女皇の書架	 、きゅう、りえぞー、えりん、じの	 、ぽん、きゅう、えりん、れいにー、みずき、まつい、れみあ、ほがらか、えなみ、labo、ぴよな、しらやま、りんな、じの、ソルト
新世界のユキサキ	えなみ、崎、しらやま、じの、ぴよな、りんな、まつい、ソルト、りえぞー	崎、しらやま、つばめ、りんな、だいこん、れみあ、えなみ、まつい、ぽったー、ぴよな、
誠実な十字架	えなみ、つばめ、ぴよな、じの	えなみ、えりん、れみあ、ほがらか、れいにー、まつい、ぴよな、りんな、あんころ、じの、つばめ、ソラ、ぽん、だいこん、ソルト、モリシ、ぽったー
鉄紺の証言	えなみ、きゅう	ぽん、まつい、ほがらか、えなみ、きゅう、れみあ、labo、れいにー、りんな、ソラ、ぽったー、モリシ
霧に眠るは幾つの罪	えなみ、まつい、きゅう、れいにー（テスト未定）、崎、ぽったー（テスト未定）	えなみ、きゅう、ほがらか、みずき、えりん、ぽん、りえぞー、れいにー、崎、まつい、あんころ、labo、ソラ、ぽったー、だいこん、ソルト、つばめ（１月体験予定）
野槌	きゅう	きゅう、えなみ、ほがらか、れみあ、まつい、れいにー、りえぞー
贖罪のロザリオ		えりん、れいにー、えなみ、きゅう、れみあ、ソラ、つばめ、
機巧人形の心臓	じの、ぴよな、きゅう、つばめ、しらやま、ソルト、りえぞー(11月テスト)	そら、ミカノハ、あんころ、モリシ、ぽったー、りんな、ソルト、ぴよな、つばめ、しらやま、labo、えりん、だいこん、温風リン、奏兎
境界線のカーサスベリ	そら（仮）、つばめ（仮）、崎（11/3テスト）、しらやま(9/30テスト)、ソルト(10/28テスト)	りんな、れみあ、しらやま、崎、ぴよな、モリシ、つばめ、じの、キュウ、だいこん
藍雨廻逢	そら、ぴよな、つばめ、じの(11月中旬テスト)、りんな(11月テスト予定)	えりん、ぴよな、つばめ、そら、じの、れみあ、あんころ、kanade、渚咲、温風リン
inthebox〜長い熱病	れいにー、じの、崎(11/9テスト)	じの、りんな、キュウ、そら、つばめ、モリシ、ぽったー、まつい、崎(11/1)、だいこん、しらやま(11/1)
GARDENリーガー殺人事件	 、りえぞー	みずき、りえぞー、れいにー、えなみ
Jazzy	ぽん	ぽん、きゅう、えなみ、つばめ、崎、モリシ
REDRUM01泉涌館の変転	ソラ	えりん、ぽったー、そら、ミカノハ、まつい、labo
アオハルーツ	えなみ、りえぞー	えなみ、みずき、れみあ、りえぞー、ほがらか、れいにー、えりん、ぽん、まつい（予定あり）、つばめ（予定）、ソラ
アオハループ	 、みくみん、みずき、りえぞー、しらやま、ぽん、つばめ、(りんな)	 みくみん、みずき、ぽん、えりん、れいにー、きゅう、まつい、りえぞー、こが、えなみ、ほがらか、れみあ、しらやま、ぴよな、りんな、あんころ、つばめ、ソラ、じの、モリシ、ソルト、温風リン
あくなき世界で嘘をうたう	ぽん、えなみ、みずき、りんな	 、みくみん、みずき、ぽん、えりん、まつい、きゅう、えなみ、れみあ、れいにー、りんな、つばめ、ぴよな
エデンの審判	きゅう、崎（覚えたい）	 、ぽん、れいにー、ほがらか、まつい、えなみ、きゅう、れみあ、みずき、えりん、ぽったー、崎、じの
キングを殺すには		 、れみあ、きゅう、みずき、りえぞー、ほがらか、えなみ、れいにー、崎、あんころ、だいこん
クロノフォビア	ほがらか、 、りえぞー、きゅう、つばめ、モリシ	 、ほがらか、えなみ、れみあ、れいにー、まつい、ぽん、えりん、みずき、りえぞー、きゅう、崎、labo、つばめ、だいこん、ぽったー、モリシ
スターループ	ぽん、れいにー、じの、ぴよな、しらやま	ぽん、えなみ、れいにー、じの、あんころ、しらやま(予定)、温風リン
ツグミドリ	えなみ、りえぞー、きゅう、りんな、ソラ、えりん、まつい	しらやま、れいにー、まつい、ぴよな、りんな、あんころ、じの、ソラ、ミカノハ、ソルト、えりん
ナナイロの迷宮 黄 エレクトリカル吹奏楽部殺人事件	 、ぽん、みずき、れいにー、きゅう、れみあ	 、えりん、みずき、ぽん、れみあ、古賀、れいにー、ほがらか、えなみ、きゅう、つばめ、ソルト
ナナイロの迷宮 緑 アペイロン研究所殺人事件	きゅう、れみあ、りえぞー、つばめ	つばめ
ナナイロの迷宮 橙 オンラインゲーム殺人事件	 、ぽん、みずき、れいにー、えりん、きゅう、れみあ、つばめ	 、えりん、みずき、ぽん、れみあ、古賀、れいにー、ほがらか、まつい、えなみ、きゅう、つばめ、ミカノハ、ソルト、だいこん
ピタゴラスの篝火	きゅう、えなみ、れみあ	 、みずき、ぽん、れいにー、れみあ、きゅう、えりん、えなみ、labo、ソルト
フェイクアブダクション		えなみ
ヤノハのフタリ	えなみ、りえぞー	 、ぽん、れいにー、きゅう、りえぞー、えなみ、みずき(貸切予定)、しらやま、labo、ぽったー、ソルト、つばめ、りんな、だいこん、kanade
ロックドドア殺人	みくみん	みくみん、えなみ、りえぞー
一条家の人々	えなみ、きゅう	ぽん、まつい、えなみ、きゅう
花咲の箱庭	みずき	みずき、ぽん、れみあ、えなみ、まつい
学校の解談	みずき、りえぞー、えりん、えなみ	みくみん、みずき、ぽん、きゅう、まつい、りえぞー、ほがらか、えなみ、れいにー、れみあ、ぴよな、りんな、あんころ、つばめ、labo(予定)、ソラ、ぽったー
岐路に降り立つ	まつい、きゅう、れみあ、えなみ、	ぽん、れみあ、きゅう、まつい、りえぞー、みずき、れいにー、ほがらか、えりん、えなみ、 、labo、ソラ、ぽったー、つばめ、モリシ
季節のマーダーミステリー／ニィホン	(季節マダミスできる全てのGM）	 、えりん、みずき、ぽん、れいにー、崎、まつい、つばめ、りんな（予定）、しらやま
季節マーダー／アニクシィ	 、ぽん、きゅう、えなみ、りえぞー、えりん、れみあ、れいにー、みずき、崎、りんな、つばめ	 、みくみん、みずき、ぽん、えりん、れいにー、れみあ、きゅう、まつい、りえぞー、古賀、ほがらか、えなみ、崎、labo、りんな、あんころ、つばめ、ソルト、しらやま、モリシ、だいこん、渚咲
季節マーダー／カノケリ	 、ぽん、きゅう、えなみ、りえぞー、えりん、れみあ、れいにー、みずき、崎、りんな、ぴよな、つばめ	 、みくみん、みずき、ぽん、えりん、れいにー、れみあ、きゅう、まつい、りえぞー、ほがらか、えなみ、崎、labo、りんな、つばめ、ソルト、しらやま、あんころ、だいこん、渚咲
季節マーダー／キモナス	 、ぽん、れいにー、れみあ、きゅう、えなみ、りえぞー、えりん、崎、りんな、みずき	 、みくみん、みずき、ぽん、えりん、れいにー、れみあ、きゅう、まつい、りえぞー、ほがらか、えなみ、崎、labo、しらやま、りんな、つばめ、だいこん
季節マーダー／シノポロ	 、ぽん、れいにー、れみあ、きゅう、えなみ、りえぞー、えりん、崎、ぴよな(10月テスト予定)、しらやま(10月テスト)、みずき、りんな(10月テスト)	 、みずき、ぽん、えりん、れいにー、れみあ、きゅう、まつい、りえぞー、えなみ、崎、ソウタン、しらやま、ぴよな、りんな、つばめ、だいこん、ソルト、モリシ
鬼哭館の殺人事件	 、みずき、れいにー,まつい、ソラ	 、みずき、れいにー、れみあ、きゅう、まつい、りえぞー、ほがらか、ぽん、えなみ、えりん、崎、ぴよな、labo、りんな、あんころ、ソラ、ミカノハ、だいこん、ぽったー、じの、ソルト、つばめ、モリシ、奏兎
古鐘のなる頃に	まつい、えなみ、きゅう	 、みずき、ぽん、れいにー、きゅう、まつい,、れみあ、りえぞー、えなみ、labo、しらやま、
荒廃のマリス	 、ぽん、きゅう、りえぞー、えりん、みずき、えなみ、まつい	 、ぽん、えりん、れいにー、きゅう、まつい、りえぞー、みずき、ほがらか、えなみ、崎、ソウタン、labo、あんころ、kanade
黒の眺望	まつい、だいこん仮	きゅう、まつい、れみあ、えなみ、つばめ、れいにー(2/6)、だいこん
今日も涙の雨が降る	ほがらか	 、えりん、れみあ、まつい、えなみ、ぽん
殺神罪	みずき、まつい、しらやま、つばめ	 、みずき、ぽん、れみあ、古賀、ほがらか、まつい、えなみ、えりん、きゅう、れいにー、崎、しらやま、labo、ぴよな、あんころ、つばめ、ソラ、じの、だいこん、モリシ、奏兎
殺人鬼イバラノミチの回想録	ぽん、りえぞー、きゅう、れいにー	ぽん、えりん、ほがらか、れいにー、 、きゅう、れみあ、りえぞー、えなみ、崎、labo、あんころ、ソラ、ソルト、しらやま(12/13予定)
紫に染まる前に	まつい、えりん	みくみん、ぽん、えりん、まつい、 、きゅう、れみあ、みずき、えなみ、しらやま、つばめ、れいにー
七股高校	みくみん	みくみん、えなみ
朱き亡国に捧げる祈り	 、きゅう、まつい、れいにー、えなみ、だいこん仮	 、ぽん、れいにー、きゅう、まつい、えりん、みずき、れみあ、ほがらか、えなみ、labo、つばめ、だいこん
少年少女Aの独白	りえぞー、えなみ、GM増やしたい	 、ぽん、えりん、れみあ、きゅう、まつい、りえぞー、ほがらか、えなみ、しらやま、つばめ、ミカノハ、ぽったー、kanade、奏兎
真・渋谷陰陽奇譚	そら、崎	崎、そら、しらやま、あんころ、kanade
人狼を語る館	きゅう、まつい	みずき、れいにー、きゅう、まつい、ぽん、えなみ、 、ソラ
星空のマリス	ぽん、えりん、きゅう、えなみ、りえぞー、みずき、まつい	 、みくみん、ぽん、えりん、れいにー、れみあ、きゅう、まつい、古賀、りえぞー、みずき、ほがらか、えなみ、崎、ソウタン、labo、あんころ、ソラ、ミカノハ、ぽったー、kanade
全能のパラドックス	 、えなみ、ほがらか、もりし仮、ポッター仮	 、えりん、れいにー、きゅう、まつい、えなみ、れみあ、みずき、ぽん、しらやま、labo、ぽったー、モリシ、あんころ
想いは満天の星に	 	えりん、みずき、まつい、 、れみあ、古賀、えなみ、りえぞー、きゅう、れいにー、labo、だいこん
探偵撲滅	 、みずき、じの	 、みずき、ぽん、えりん、れいにー、きゅう、まつい、りえぞー、れみあ、ほがらか、えなみ、labo(予定)、じの、つばめ、モリシ
天邪河（あまのじゃく）	まつい、みずき仮、しらやま	ほがから、れいにー、みずき、 、しらやま、まつい、りんな、あんころ、つばめ、ぴよな、ソラ、じの、labo、だいこん、れみあ
電脳の檻のアリス	えりん、じの、ぴよな、りえぞー	えなみ、えりん、みずき、きゅう、つばめ、しらやま、れみあ、じの、そら、れいにー、ぴよな、モリシ、りんな、ミカノハ、あんころ
白殺しType-K	きゅう、しらやま、えりん	れいにー、みずき、れみあ、ほがらか、まつい、えなみ、きゅう、りえぞー、しらやま、 、ぴよな、りんな、あんころ、じの、つばめ、崎、ぽったー、えりん
百鬼の夜、月光の影	みずき、しらやま、りんな	みずき、えりん、れみあ、古賀、ぽん、えなみ、まつい、れいにー、しらやま、ぴよな、りんな、あんころ、じの、つばめ、ソラ、ミカノハ、ぽったー、モリシ
名探偵と四嶺館	まつい	れいにー、れみあ、まつい、えなみ、きゅう、ぽん
傲慢な女王とアリスの不条理裁判	ぽん、えりん、りえぞー、みずき、れいにー、りんな、しらやま	 、みくみん、みずき、ぽん、えりん、きゅう、りえぞー、れいにー、古賀、ほがらか、えなみ、まつい、しらやま、labo、つばめ、じの、りんな、ぽったー
彗星蘭の万朶	しらやま、あんころ、りんな、じの	えりん、 、れいにー、きゅう、みずき、ほがらか、しらやま、まつい、りんな、あんころ、じの、まつい、ソウタン、みずき、えりん、えなみ、しらやま、あんころ、だいこん、崎、温風リン
燔祭のジェミニ	えなみ、りえぞー、じの、つばめ、しらやま、りんな、えりん	れいにー、しらやま、 、じの、つばめ、りえぞー、りんな、あんころ、じの、つばめ、えりん、ソラ、まつい、ミカノハ、だいこん、キュウ、みずき
絆の永逝	ぽん	 、みずき、ぽん、えりん、れいにー、れみあ、りえぞー、まつい、ほがらか、えなみ、しらやま、あんころ、つばめ、ミカノハ、kanade、奏兎
異能特区シンギュラリティ	あんころ	崎、じの、ぽったー、まつい、ぴよな、モリシ、えりん(7/14)、キュウ、あんころ、つばめ、温風リン
くずの葉のもり	じの・つばめ・そら・りえぞー	崎、じの、そら、つばめ、ぽったー、まつい、ぴよな、りんな、モリシ、れみあ、ソルト、えりん
REDRUM4アルテミスの断罪	そら	そら、ぽったー、渚咲
ENIGMACODE廃棄ミライの犠牲者たち	ほがらか、じの、れみあ、(ぽったー)	つばめ、りんな、ぽったー、そら、ソルト、あんころ、えりん、labo、れみあ、だいこん、温風リン、奏兎
テセウスの方舟	ほがらか、つばめ、じの(11月予定)、ソルト(10/27テスト)	キュウ、りんな、labo、つばめ、そら、じの、れみあ、ぽったー、そら、ソルト、ミカノハ、モリシ
月光の偽桜	つばめ,そら、崎（テストしたい）、ぴよな、しらやま(9月テスト予定)、ソルト	えりん、キュウ、つばめ、りんな、れみあ、そら、しらやま、ぴよな、ソルト、ぽったー、あんころ、崎、モリシ、じの、まつい、だいこん、kanade
探ぱんマーダーミステリー・ノーショーツトルダム学園殺人事件	じの	キュウ、りんな、れみあ、ソルト、ミカノハ、じの、あんころ、ぽったー、BB、楽
蟻集	キュウ、崎(12月テストしたい)、ぴよな(11月テスト予定)	りんな、崎、キュウ、えりん、labo、みずき、つばめ、ぴよな、だいこん、しらやま
蝉散	キュウ、崎(1月テストしたい)、ぴよな(12月テスト予定)	りんな、崎、キュウ、えりん、labo、みずき、ぴよな(予定あり)
5DIVE	 、きゅう、じの、しらやま、ぴよな	 、きゅう、れみあ、みずき、りえぞー、えなみ、れいにー、まつい、ぽん、しらやま、崎、ソウタン、labo、ぴよな、りんな、じの、あんころ、つばめ、えりん(12/20予定）ソラ、だいこん、ぽったー、ソルト
MERCHANT	、みかのは、しらやま	 、みずき、えりん、きゅう、古賀、ぽん、えなみ、しらやま、崎、ぴよな、あんころ、つばめ、ミカノハ、だいこん
readme.txt	ほがらか	ぽん、きゅう、えりん、まつい、えなみ、れいにー、崎、ソルト
REDRUM02虚像のF	そら	えりん、まつい、あんころ、ソラ、ソルト、ミカノハ、ぽったー、だいこん、キュキュウ
REDRUM03致命的観測をもう一度	labo、そら、しらやま、えりん	えりん、ぽったー、そら、れいにー、ソルト、labo、しらやま、じの、ミカノハ、まつい、だいこん
TOOLS〜ぎこちない椅子	きゅう、れみあ、れいにー、ソラ	きゅう、れいにー、まつい、みずき、れみあ、えなみ、 、えりん、だいこん、ぽったー、ソラ
アンドロイドは愛を知らない	つばめ、しらやま、じの	しらやま、モリシ、ぽったー、ミカノハ、ソルト、ぴよな、つばめ、kanade、温風リン
キヲクの方舟	ぽん	 、みずき、ぽん、きゅう、まつい、りえぞー、えなみ、ぽったー
クリムゾンアート	ぽん、りえぞー	ぽん、れみあ、きゅう、みずき、りえぞー、えなみ、ほがらか、れいにー、つばめ、kanade
この闇をあなたと	 、れみあ、まつい、しらやま、そら、えなみ、じの、キュウ	えなみ、まつい、ほがらか、れみあ、れいにー、みずき、しらやま、崎、ソウタン、ぴよな、りんな、あんころ、じの、つばめ、えりん(12/22予定)、labo、ソラ、ミカノハ、だいこん、ぽったー、ソルト、モリシ、kanade
デモンズボックス	えなみ、つばめ	ぽん、れみあ、きゅう、まつい、ほがらか、えなみ、れいにー、 、崎、つばめ
へっどぎあ★ぱにっく	 、えなみ、つばめ、キュウ、しらやま(12月絶対テスト)	 、ぽん、まつい、りえぞー、みずき、えなみ、れいにー、ほがらか、きゅう、崎、つばめ、しらやま(予定)
モノクローム	りえぞー、しらやま、えりん、崎、じの、みずき、きゅう、labo、モリシ	 、りえぞー、きゅう、ぽん、えりん、みずき、れいにー、れみあ、ほがらか、まつい、えなみ、崎、ソウタン、labo、しらやま、りんな、あんころ、ぴよな、ソラ、じの、だいこん、ソルト、つばめ、モリシ、温風リン
ロスト／リメンブランス	きゅう、れみあ、れいにー、らぼ	きゅう、えなみ、れいにー、 、れみあ、みずき、えりん、ほがらか、ぽん、しらやま、崎、labo、あんころ、ぽったー、ソルト、渚咲
愛する故に	 、れいにー、みずき、モリシ、そら	ぽん、 、みずき、れいにー、ほがらか、えなみ、きゅう、崎、ソウタン、ソラ、あんころ、モリシ、ぽったー、えりん、ミカノハ、labo
椅子戦争	ほがらか、りえぞー	 、ぽん、えりん、れみあ、きゅう、りえぞー、れいにー、ほがらか、えなみ、ぴよな
違人	きゅう、labo仮	 、みずき、ぽん、えりん、れみあ、きゅう、れいにー、まつい、古賀、えなみ、じの、labo、りんな、あんころ、ぽったー
火ノ神様のいうとおり	きゅう、えなみ	まつい、きゅう、みずき、れいにー、ほがらか、えなみ、れみあ、labo
紅く舞う	まつい、きゅう	 、えりん、れいにー、みずき、れみあ、ほがらか、まつい、えなみ、きゅう、つばめ、labo
告別詩（取引中止）	しらやま、ぴよな、りえぞー（仮）	しらやま、ぴよな、りえぞー、モリシ、じの、ソラ、まつい、labo、 、みずき、あんころ、ほがらか、りんな、えなみ、ぽったー、ソルト、つばめ、モリシ
殺人鬼Xの独白	まつい、れみあ、れいにー	れいにー、 、れみあ、ほがらか、えりん、まつい、えなみ、古賀、みずき、ぽん、ソラ、ぽったー、モリシ
小暮事件に関する考察	えなみ、まつい、れみあ、labo、そら仮	えなみ、れみあ、ほがらか、えりん、まつい、古賀、 、みずき、ぽん、labo、れいにー、ぽったー、温風リン
赤の導線	れいにー、えなみ、えりん、りえぞー、しらやま、ぴよな	きゅう、れみあ、えりん、 、れいにー、りえぞー、ぽん、えなみ、古賀、みずき、崎、しらやま、ぴよな、あんころ、じの、つばめ、ソラ、だいこん、ぽったー、ソルト、りんな、温風リン
凍てつくあなたに６つの灯火	りえぞー、えりん、まつい、あんころ	みくみん、まつい、りえぞー、えなみ、ほがらか、 、れいにー、えりん、きゅう、みずき、つばめ、あんころ、モリシ
彼とかじつとマシュマロウ	ぽん、りえぞー、ソルト仮、つばめ（10月テスト）	みくみん、ぽん、まつい、りえぞー、えなみ、ほがらか、えりん、ソウタン、れいにー、labo、ぴよな、つばめ
彼女といるかとチョコレート	ぽん、りえぞー、えりん、ソルト	みくみん、ぽん、えりん、きゅう、まつい、りえぞー、えなみ、ほがらか、みずき（企画中）、れいにー、labo、つばめ
不思議の国の童話裁判	みずき、りえぞー、えりん、つばめ、きゅう、じの	 、みずき、ぽん、えりん、れいにー、れみあ、きゅう、りえぞー、こが、ほがらか、えなみ、しらやま、りんな、あんころ、つばめ、ぴよな、ソラ、じの、温風リン
鳴神様のいうとおり	ぽん、きゅう、えなみ、りえぞー	ぽん、きゅう、みずき、まつい、りえぞー、れいにー、れみあ、ほがらか、えなみ、ソウタン、labo、つばめ、渚咲
立方館	labo、まつい仮、ぽったー仮	キュウ(5/20プレイ予定)、しらやま、つばめ、ぽったー、まつい、ソルト、崎（10/19予定）、えりん、だいこん、温風リン
裂き子さん	ぽん、りえぞー、みずき、きゅう、ぴよな、つばめ	 、みくみん、ぽん、れみあ、きゅう、りえぞー、みずき、れいにー、ほがらか、えなみ、まつい、ぴよな、つばめ、えりん、しらやま、ぽったー、じの、あんころ
ゴージャスマンション	だいこん、しらやま	ぴよな、りんな、あんころ、じの、モリシ、えりん、れみあ、だいこん、しらやま
マーダーオブエクスプローラー失われし大秘宝	ソラ	じの、古賀、ソラ、あんころ、りんな、じの、つばめ、えりん、キュウ、れみあ、ぽったー、だいこん
漣の向こう側	じの、つばめ、ぴよな	ぴよな、つばめ、じの、あんころ、りんな、ぽったー
土牢に悲鳴は谺して	まつい・きゅう	えりん、りんな、そら、ぽったー
オペレーション：ゴーストウィング	えなみ、そら、(りんな)	えなみ、そら、りんな、らの、ぽったー、れみあ、みかのは、つばめ（12/30予定）、キュウ(11.22予定)
GM殺人事件	じの、りんな、あんころ、ソウタン、だいこん	ミカノハ、つばめ、じの、りんな、ソルト、ぴよな、あんころ、そら、だいこん、らぼ、しらやま、もりし、ソウタン、ぽったー
BeatSpecter	きゅう（仮）	そら、ミカノハ、あんころ、ぽったー、らぼ、れいにー、れみあ
WORLDEND	ぽん、りえぞー、あんころ、つばめ、みかのは	 、ぽん、きゅう、まつい、りえぞー、みずき、れみあ、えなみ、しらやま、あんころ、つばめ、れいにー、ミカノハ、だいこん、ぽったー
あるマーダーミステリーについて	えなみ、まつい、れみあ、りえぞー、えりん、れいにー、labo、しらやま、ソルト	えなみ、 、えりん、まつい、りえぞー、ほがらかプレイ予定、みずき、きゅう、れみあ、ぽん、れいにー、崎、labo、ぴよな、ソラ、ミカノハ、ぽったー、ソルト、しらやま、モリシ、だいこん
エイダ	 、りえぞー、みずき、ソルト、しらやま、あんころ	 、みくみん、みずき、ぽん、えりん、れいにー、れみあ、きゅう、まつい、古賀、りえぞー、ほがらか、えなみ、しらやま、崎、ぴよな、labo、あんころ、じの、つばめ、ソラ、ミカノハ、だいこん、ぽったー、kanade、渚咲、温風リン、奏兎
ブラックナイトスレイヴ		えりん、れみあ、えなみ
ユートピアース	しらやま・じの、つばめ、あんころ	しらやま、じの、つばめ、れいにー、あんころ、りんな、ミカノハ、キュウ、ぽったー、みずき
狂気山脈　2.5　頂上戦争	れいにー、れみあ	えなみん、  、れいにー、れみあ、崎、ソウタン、みずき(予定)、だいこん、しらやま、
狂気山脈　陰謀の分水嶺（１）	れいにー、れみあ	 、みずき、ぽん、えりん、れいにー、れみあ、古賀、りえぞー、まつい、ほがらか、えなみ、しらやま、崎、ソウタン、ぴよな、labo、あんころ、つばめ、ミカノハ、だいこん、ぽったー、そら、kanade、渚咲、奏兎
狂気山脈　星降る天辺（２）	れいにー、れみあ	みずき、えりん、れいにー、れみあ、 、りえぞー、まつい、えなみ、しらやま、崎、ソウタン、labo、あんころ、ミカノハ、だいこん、ぽったー、そら、kanade、奏兎
狂気山脈　薄明三角点（３）	れいにー、れみあ	れいにー、れみあ、りえぞー、えりん、 、みずき、えなみ、しらやま、崎、ソウタン、labo、あんころ、ミカノハ、だいこん、ぽったー、奏兎
午前2時7分	えなみ、きゅう、れみあ	れいにー、みずき、れみあ、ぽん、えりん(予定未定)、ソラ
黒い森の獣part1	 、まつい、れいにー	 、ぽん、きゅう、古賀、りえぞー、まつい、ほがらか、れいにー、えなみ、ソラ、だいこん
黒い森の獣part2人と狼	 、まつい、れいにー？	 、まつい、きゅう、れみあ、古賀、ほがらか、えなみ、みずき、れいにー、ソラ、だいこん
魂を運ぶ飛行船	つばめ、りんな、ソルト	りんな、ソルト、つばめ、奏兎
人類最後の皆様へ／終末の眠り姫	 、あんころ	 、えりん、れみあ(人類最後のみ)、ぽん、古賀、みずき、えなみ、崎（人皆のみ）、ぴよな、labo(人類最後のみ)、あんころ、つばめ（人類のみ）、だいこん、ぽったー(人類最後のみ)、モリシ
正義はまた蘇る	えなみ、まつい	みずき、ぽん、れいにー、きゅう、まつい、えなみ、つばめ
天使は花明かりの下で	 、りえぞー、みずき、ぴよな、ぽん、しらやま、あんころ	 、古賀、みずき、えりん、りえぞー、ぽん(予定)、れいにー、えなみ、しらやま、あんころ、つばめ、ソラ、ミカノハ、だいこん、ソルト、じの、labo、奏兎
南極地点X	れいにー、まつい	 、ぽん、れいにー、れみあ、まつい、ほがらか、えなみ、あんころ、ミカノハ、だいこん、ソルト、りんな、kanade
僕らの未来について	まつい	ぽん、まつい、れみあ、ほがらか、えなみ、 、きゅう
魔女の聖餐式	えなみ	ぽん、えりん、れみあ、まつい、古賀、えなみ、れいにー、だいこん、キュウ
流年	えりん、れいにー、モリシ、あんころ	 、れいにー、ぽん、みずき、れみあ、ほがらか、えりん、きゅう、ソウタン、ぴよな、あんころ、つばめ、しらやま、じの、ミカノハ、モリシ
廻る弾丸輪舞（ダンガンロンド）	まつい・そら	じの、えりん、れみあ、まつい、そら、あんころ、崎
TheRealFork30's	ソラ、りえぞー	ぴよな、りんな、あんころ、じの、モリシ、キュウ
檻見る5人-（空色時箱セット公演）	そら、つばめ	じの、そら、つばめ、ぴよな、もりし、あんころ、しらやま、りえぞー
空色時箱（ソライロタイムカプセル）-檻見る５人セット公演	つばめ仮、そら	じの、そら、つばめ、もりし、えなみ、あんころ、しらやま、りえぞー
MissingLink（ミッシングリンク）	えなみ	崎、しらやま、ソラ、じの、あんころ、ミカノハ、ぽったー、つばめ
ゼロの爆弾	そら、じの	キュウ、えなみ、ポッター、そら、しらやま、れみあ、りんな、あんころ、つばめ
赤鬼が泣いた夜	つばめ	つばめ、あんころ、ぴよな、まつい、そら、じの
SORCIER～賢者達の物語～	 、きゅう、みずき、つばめ	 、みくみん、みずき、きゅう、えなみ、ほがらか、しらやま、じの、つばめ、りんな、ミカノハ、だいこん
あの夏のアンタレス	れいにー、ぽん	ぽん、れいにー、れみあ、こが、えなみ、しらやま
エンドロールは流れない	 、みずき、あんころ、ぽん、そら、ソルト	 、えりん、みずき、古賀、まつい、ぽん、えなみ、ほがらか、れみあ、れいにー(予定)、きゅう、しらやま、崎、ぴよな、labo、りんな、あんころ、つばめ、ソラ、ミカノハ、だいこん、ソルト、モリシ、kanade、温風リン、奏兎
幻想のマリス	れいにー、きゅう、えなみ、みずき	 、みくみん、えりん、れいにー、れみあ、きゅう、まつい、りえぞー、ほがらか、えなみ、みずき、labo、kanade
Invisible-亡霊列車-	えなみ、じの、そら、キュウ、つばめ、古賀、あんころ、みかのは、りえぞー	じの、古賀、ソラ、あんころ、りんな、じの、つばめ、キュウ、しらやま、ソルト、ミカノハ、ぽったー、えりん(ｵﾝﾗｲﾝ)、まつい、labo、kanade
口裂け女の微笑み・Mの悪意	未定	キュウ
Grape		じの、キュウ、えりん
Factor		つばめ、キュウ、えりん
親方の館		そら、ぴよな、あんころ、ミカノハ、キュウ
アンシンメトリー	キュウ	そら、つばめ、ソルト、ぽったー、れみあ
妖怪たちと月夜の刀	崎(10/26テスト)、じの	崎、そら、じの、つばめ、あんころ
ある悪魔の儀式について	えなみ、れみあ	しらやま(予定)、じの、そら、温風リン
ブルーダイヤの不在証明	えなみ	キュウ、崎、じの、そら
ツイン号沈没事件に関する考察	えなみ	えりん(1月予定)
九十九談 - 厄災の箱		
呪縛姫		
深海に沈む子供たち（水底に生きる）	じのやりたい	つばめ、ソルト、あんころ、ぴよな、そら、キュウ
その白衣は誰が為に	キュウ	
人狼デスゲームへの挑戦		温風リン
すべては山荘から始まる。		

